"filename", "language", "C#", "CSV", "comment", "blank", "total"
"h:\unity\SE-LOCM\SE_LOCM\Assets\Script\battle\BezierArrows.cs", "C#", 52, 0, 0, 13, 65
"h:\unity\SE-LOCM\SE_LOCM\Assets\Script\battle\Buff.cs", "C#", 34, 0, 0, 6, 40
"h:\unity\SE-LOCM\SE_LOCM\Assets\Script\battle\Card.cs", "C#", 64, 0, 0, 3, 67
"h:\unity\SE-LOCM\SE_LOCM\Assets\Script\battle\CardDatabase.cs", "C#", 26, 0, 0, 2, 28
"h:\unity\SE-LOCM\SE_LOCM\Assets\Script\battle\CardTemplate.cs", "C#", 85, 0, 4, 4, 93
"h:\unity\SE-LOCM\SE_LOCM\Assets\Script\battle\DiscardPile.cs", "C#", 23, 0, 1, 3, 27
"h:\unity\SE-LOCM\SE_LOCM\Assets\Script\battle\DisplayController.cs", "C#", 125, 0, 1, 13, 139
"h:\unity\SE-LOCM\SE_LOCM\Assets\Script\battle\DrawPile.cs", "C#", 49, 0, 13, 6, 68
"h:\unity\SE-LOCM\SE_LOCM\Assets\Script\battle\Enemy.cs", "C#", 138, 0, 5, 5, 148
"h:\unity\SE-LOCM\SE_LOCM\Assets\Script\battle\GameController.cs", "C#", 226, 0, 29, 17, 272
"h:\unity\SE-LOCM\SE_LOCM\Assets\Script\battle\HandCards.cs", "C#", 26, 0, 2, 3, 31
"h:\unity\SE-LOCM\SE_LOCM\Assets\Script\battle\HandCardsUI.cs", "C#", 154, 0, 11, 14, 179
"h:\unity\SE-LOCM\SE_LOCM\Assets\Script\battle\Player.cs", "C#", 49, 0, 0, 4, 53
"h:\unity\SE-LOCM\SE_LOCM\Assets\Script\battle\RoundButton.cs", "C#", 36, 0, 0, 2, 38
"h:\unity\SE-LOCM\SE_LOCM\Assets\Script\battle\carddb.csv", "CSV", 0, 23, 0, 0, 23
"Total", "-", 1087, 23, 66, 95, 1271